#####################
#####################
#####################
#####################
#####################
#####################
##########.....X#####
##########.##########
##########.##########
##########.##########
##########.##########
##########.##########
##########.##########
##########.##########
##########.##########
##########.##########
###TH......##########
#####################
#####################
#####################
#####################