#####################
#####################
#####################
#####################
#####################
####.....#X#.....####
####.##SS#.#SS##.####
####.##SS#.#SS##.####
####.SS.......SS.####
####.##.S###S.##.####
####.##.SSSSS.##.####
####.SS.SS#SS.SS.####
####.SS.SS#SS.SS.####
####.##.SSSSS.##.####
####.##.S###S.##.####
####.SS.......SS.####
####.##SS#.#SS##.####
####.##SS#H#SS##.####
####.....#T#.....####
#####################
#####################