#####################
#####################
#####################
#####...........#####
#####.#########.#####
#TH................X#
#####.##.######.#####
#####....######.#####
##....##.######.#####
##.#####.######.#####
##..............#####
#####################