#####################
#####################
#####################
#####################
#####################
#####################
#####..........X#####
#####.####.####.#####
#####.#.......#.#####
#####.#.##.##.#.#####
#####.#.#...#.#.#####
#####.....#.....#####
#####.#.#...#.#.#####
#####.#.##.##.#.#####
#####.#.......#.#####
#####.####.####.#####
###TH...........#####
#####################
#####################
#####################
#####################