#####################
#####################
#####################
#####################
#####################
#####################
#####################
#####################
#####################
#######.II.II.#######
#######.II.II.#######
##>.....II.II......X#
#######.II.II.#######
#######.II.II.#######
#####################
#####################
#####################
#####################
#####################
#####################
#####################