#####################
#####################
#####################
#####################
#########SSS#########
#########SXS#########
#########S.S#########
######SSSS.SSSS######
######S#.....#S######
######S.SSSSS.S######
######S.S...S.S######
######S.S.#.S.S######
######S.S.#.S.S######
######S.S...S.S######
######S.SSSSS.S######
######S#.....#S######
######SSSS.SSSS######
#########S^S#########
#########SSS#########
#####################
#####################