#####################
#####################
#####################
#####...........#####
#####.#########.#####
#TH................X#
#####.##.############
#####....############
#####################
#####################
#####################
#####################