#####################
#####################
#####################
#####################
#####################
#####################
#####...........#####
#####.#.#.#.#.#.#####
#####..I.....I..#####
#####.#.#.#.#.#.#####
#####....I.I....#####
#TH...#.#.#.#.#....X#
#####....I.I....#####
#####.#.#.#.#.#.#####
#####..I.....I..#####
#####.#.#.#.#.#.#####
#####...........#####
#####################
#####################
#####################
#####################