#####################
#####################
#####################
#####################
#####################
#####################
#####################
#####################
#####################
#######.II.II.#######
#######.II.II.#######
#TH.....II.II......X#
#######.II.II.#######
#######.II.II.#######
#####################
#####################
#####################
#####################
#####################
#####################
#####################