#####################
#####################
#####################
##########X##########
##########.##########
##########.##########
##########.##########
##########.##########
########.....########
########.###.########
########.###S########
########.#..S########
########.#..S########
########.###S########
########.###.########
########.....########
##########.##########
##########.##########
##########^##########
#####################
#####################