#####################
#####################
#####################
#####################
#####################
#####################
##.................##
##.######...######.##
##.#SSSS#.#.#SSSS#.##
##.#SS#S..#..S#SS#.##
##.#SS#S..#..S#SS#.##
##.#SSSS#.#.#SSSS#.##
##.######...######.##
##.................##
#########.S.#########
#SSX......S.......###
#SS>SSSSSSSSSSSSS.###
#SSX..............###
#####################
#####################
#####################