#####################
#####################
#####################
#####################
#############X#######
########..#...IIII.##
########I..I..#..#I##
########I#..#..I..I##
########.IIII...#..##
#############I#######
##########.I..II.####
##########I#.I.#I####
##########.II..I.####
#############I#######
#############I#######
#SS######..##I#######
#SS>IIIII.I.I.#######
#SS#######..#########
#####################
#####################
#####################