#####################
#####################
#####################
#####################
#####################
#####################
#####..........X#####
#####.####.####.#####
#####.####.####.#####
#####.####.####.#####
#####.###...###.#####
#####...........#####
#####.###...###.#####
#####.####.####.#####
#####.####.####.#####
#####.####.####.#####
####>...........#####
#####################
#####################
#####################
#####################