#####################
#####################
#####################
#####################
#####################
#####################
#####################
#####################
##................###
##.#..............###
##X###########....###
##.###########....###
##................###
###############...###
###############...###
###############...###
#SS############...###
#SS>..............###
#SS##################
#####################
#####################