#####################
#####################
#####################
#####################
#####################
#####################
#####..........X#####
#####..........######
#####..........######
#####..........######
#####..........######
#####..........######
#####..........######
#####..........######
#####..........######
#####..........######
####>..........######
#####################
#####################
#####################
#####################