#####################
#####################
#####################
#####################
#####################
#####################
#####...........#####
#####.##..#..##.#####
#####.#IIIIIII#.#####
#####..I.....I..#####
#####..II.I.II..#####
##>...#II.I.II#....X#
#####..II.I.II..#####
#####..I.....I..#####
#####.#IIIIIII#.#####
#####.##..#..##.#####
#####...........#####
#####################
#####################
#####################
#####################