#####################
#####################
#####################
#####################
#####################
#####################
#####################
#####################
#####################
#####################
#####################
#####################
###############X#####
###############.#####
##########.....I.####
#SS#.....#..#.I..####
#SS>IIIII...#..I.####
#SS#.....#..#..######
#####################
#####################
#####################