#####################
#####################
#####################
#####################
#####################
#####################
#####################
#####################
#####################
#####################
#####################
#####################
##X...............###
###############...###
###############...###
###############...###
#SS############...###
#SS>..............###
#SS##################
#####################
#####################