#####################
#####################
#####################
#####################
#####################
#####################
#####################
####...............##
####.#SS##SSS##SS#.##
####.S...#...#...S.##
####.S.SS#S#S#SS.S.##
####.#.S...#...S.#.##
####.#.###X#X###.#.##
####.#.#.X#X#X.#.#.##
####.#.S.......S.#.##
#SS#.S.SS##S##SS.S.##
#SS>.S...#...#...S.##
#SS#.#SS##SSS##SS#.##
####...............##
#####################
#####################