#####################
#####################
#####################
#####################
#####################
#####################
#####################
#####################
####....#.........###
####.##.#.#...#...###
###X......#...#...###
###X......#...#...###
####.##.#.#...#...###
####....#.........###
#################.###
#####...#...#...#.###
#SS##.#.#.#.#.#.#.###
#SS>..............###
#SS####.#.#.#.#.#.###
#######...#...#...###
#####################