#####################
#####################
#####################
#####################
#####################
#####################
#####################
#####################
#####################
#####################
#####################
#####################
#####################
#####################
####...............##
#SS#.#############.##
#SS>.#############.X#
#SS#S#SSS#SSS#SSS#S##
####SSS#SSS#SSS#SSS##
#####################
#####################