#####################
#####################
#####################
#####################
#####################
#####################
###########XIIII.II##
###########XI.II.II##
###########XIII.II.##
###########XIII.I.I##
###########XIIIIIII##
###########XI.III.I##
##################.##
##################.##
####.II.I#.......#.##
#SS#IIIII#.......#.##
#SS>..I...I.I#I.I..##
#SS#IIII.#.......####
####I.II.#.......####
#####################
#####################